***************
S             *
************* *
*             *
* *************
*             *
* * * *********
*             *
*   * *  *  * *
* *** ******* *
*           * *
* ***** G *** *
* *****   *** *
*             *
***************
