****************************************************************************************************************
*     *       *     *         *   *       * * *   *   * *     * *     * * * *     * *   *   * * *   *     *  * *
***** ******* * *** ******* *** ***** * *** * *** * *** * *** * ***** * * * ***** * * *** *** * *** *** **** * *
*   *       *   *   * * *         *   *     *     *       *   *   * * *       *             *   * * * *   *  * *
* ********* ***** *** * ******* * ******* * ***** ***** * *** *** * * ***** *** ******* * ***** * * * * **** * *
* *   *                   * *   * * *   * * * *       * * *                   * * * *   *         *       *  * *
* * ********************* * ***** * *** * *** *** * *************** * * *** * *** * ************* ******* *  * *
* * *   *   *   *             *   * *     * *   * * * *   *     *   * * *   *     * * *   * *             *    *
* * *** *** *** ********* *** *** * ***** * * ***** * * ***** *************** *** * * *** * *** ********* *  ***
*   * *   * *   * *   * * *   *     *   *       *   * * * * *   * *   *       *   *   * *   * * *     *        *
* *** *** * *** * *** * ***** ***** *** *** * ***** * * * * *** * * ************* *** * * *** ******* *** ******
* *                   *           *   * * * * *           *         * *     *     *   * * *     * * *        * *
* ***** * *** ***** *********** *** * * * * *********** * ********* * ***** *** * *** * * ***** * * ***** **** *
*       * *   * *         *   *   * * *     * *S*   *   * * *   *         *   * * *     * *     * *   *   *    *
*********** *** ***** * * *** *** *** *** *** * *** ***** * *** ******* ***** *** ***** * ***** * *** *** * ****
*   * *   * * *   *   * * *   * *     *   * *   * *   *     * * * *     *   * *     *   * * *     *     *      *
*** * *** *** * ********* * *** * *** *** * *** * *** * * *** * * ***** * *** *** * * * * * ***** ***** ********
*   *   *                       * * *       *   *     * *       * * * *   * *   * *   * * *         *        * *
*** * * ******* *********** * * *** *** ******* *** * ******* * * * * * * * * ********* * ***** *** *** ****** *
*   * *   *   * *   *     * * * * * *       * *     *     *   *         *       *   *   *   *   * * * *        *
*** *** * *** ***** ***** ***** * * ***** *** * * *** ******************* * ******* * * * ******* * * **********
* * * * * * * *     *   *   *                 * * *       * * *   * *     * * * *     *   * *                  *
* * * *** * * * * ***** *** ************* * * ***** * * * * * *** * ******* * * ******* *** ***** * * *** * ****
* * *           * *     * *     *   * *   * * *   * * * *   *   * * *         *             *   * * * *        *
* * ***** *** ********* * * *** *** * *** ***** ******* * ***** * * *** * *** *** * * *** * * ********* * ** ***
*   * *   *     * * *         *   * *   *       *       *       *       * *       * * * * *       * *   * *    *
*** * ***** * *** * ***** ***** * * * ***** *** * * * *** * *** *** ******* *** ******* ********* * *** ***  ***
* *     * * * *   *     * * * * *           * * * * * *   * * * * * * * * * * * *             *       *      * *
* * ***** *** * ******* *** * * ******* *** * * ***** *** * * * * *** * * *** *************** ******* ******** *
*     *   *   * * *   * *     * *     * *   * * * *     * * *     * * * *   *       *     *   * * * *   *      *
*** ***** * * * * *** * ***** ******* ***** * *** *************** * * * *** ***** * *** * * * * * * * *** * ** *
*   * *   * *   *   * * *     *         * * * * * * *   *               *   * *   *     *   *           *    * *
*** * * *** * ***** * * ***** ********* * * * * * * * *************** * * * * *********** ********* * * ****** *
* *     * * *   *   * * * * *   *             *     * *   *   * *     *   *           *   *     *   * * * *    *
* * * * * *** ***** * * * * * *********** * *** ***** * * *** * ***** * ********* *** ******* * ******* *** ** *
*   * *     *   * *               * * *   * * *     *   * * * *       * *       * *   * * *   *     * *      * *
*********** * *** *** * ********* * * ***** * * *** * * *** * *** ************* ***** * * ********* * * ****   *
* *           *     * * *   * * *     *       *   * * *     * * * *       *G          *                        *
****************************************************************************************************************   