*S***************************************************************************************************
*     * *             *     *   *   * *     * * *   *         * *   *     * * * *         * * *   * *
* ***** * * *** * *** *** ***** * *** *** *** * *** *** ******* * *** ***** * * * * ******* * * *** *
*     * * * *   * * *     * *   * *     *   *   *           * *     *     * * *   *   *             *
*** *** ******* *** ***** * *** * *** *** ***** *** *** ***** * ***** * *** * ***** *** ******* *****
* *   *   *   *   * *   * *   *       *     * *   * *   *     *   *   *     * * * *   * * * * * *   *
* * ***** *** ***** * *** *** ***** ***** *** *** *** ***** * * ***** ******* * * * * * * * * ***** *
* *   * * * * * *     *     *             * * *   * *   * * * *   *   * * * * *     * *     *   * * *
* * *** * * * * ***** ***** * ***** ******* * *** * * *** * ***** * *** * * * *** ***** * * * *** * *
* * *     *   *   * * *   *     *         *   * * *   * * * * *     *     *     *       * *   *     *
* * ***** *** * *** * *** * * *** * *** ***** * * * *** * * * *** ***** *** ***** *************** ***
*     * * * *   * * *       * *   * * *       *     * * * * * *   * *   *   *   * * *   * *   *     *
*** *** * * *** * * *************** * * ********* * * * * * * *** * * *** * * *** * * *** *** * *****
*     *   * * *     *   * * *   *   * *     * *   *   *       * *       * *   *   *         * * * * *
***** *** * * *** * *** * * * ******* * ***** ***** ***** ***** ***** ***** ***** * * * *** * * * * *
*   *   *   * * * *       * * * * *     * *           *     *     *         * *     * * *   *   *   *
*** *** *** * * *** * * *** * * * ***** * *** * * * ******* *** ***** * ***** *** ***** ***** * * * *
* * *   *     *   * * *   * * *   *     * *   * * *   * *     *   * * * * * * *       *   *   *   * *
* * * * ***** * ******* *** * * ******* * *********** * *** *** *** * *** * * * *************** * ***
* * * *       * * *   * *   * *   * * * *   *     * * *       * * *   *   *       *     * *   * * * *
* * ********* * * *** * *** * *** * * * * *** ***** * * ******* * *** * *** *** * * ***** *** * *** *
*   *       * * *       * *     * * *     * * * *     * * * *           *     * * *   * * * *     * *
*** ******* * * *** * *** *** *** * ***** * * * ***** * * * * ************* ********* * * * *** *** *
* * *   *           * * *   * * *   * *         *       *   *   *   *         * * *   *     *   * * *
* * *** ***** ******* * * *** * * *** * ***** ******* *** *** *** ********* *** * *** *** *** *** * *
* *       * * *   *     * *   * * * *       * *     * *       *   * *         * * *   * *   * * *   *
* ******* * *** *** * *** *** * * * * ************* * * ***** * *** *** * ***** * * *** * *** * *** *
*       *   * *     * *   * * *   * * * *   * * *     *     *   *     * *   *             *     *   *
***** ***** * ******* *** * * *** * * * * *** * ***** * ***** *** ******* *** *********** *** *** * *
*     * *   *     *         *     * * *   * *   * * *   * * * *   * * *     *   *   *   * * * * * * *
***** * *** *** * *** *** * ***** * * *** * *** * * * *** * *** *** * * ***** *** *** *** * * * * ***
*       *   * * *     * * *   * *     * *   * *   * *     * *   *     *   * *           * *         *
******* *** * * ******* * *** * * * *** * *** * *** * *** * * *** ***** *** * ***** ******* ***** ***
* *   *         *   * * * *   *   *   *   * * *       * * *   *   *   *         * *     *     *     *
* *** ***** * ***** * * ***** ***** ***** * * * *** *** *** *** *** *** *** *** * ********* *********
*   *     * * *             *       *         *   * * * *   * *   *       * * * *     * *     *   * *
*** *** ************* *** * * * *** ***** ***** ***** * * *** * *** * *** * * *** *** * * *** * *** *
* * *   *   * *   * * *   *   * * *   * *     *   *   * *   *       *   * * *       * * * *     *   *
* * *** *** * *** * ********* *** * *** *** *** *** * * * *** *************** * *** * * ******* * ***
* *     * *         *   *     *     * * *     *   * *   *             * *     *   * *     *   * *   *
* ***** * * * ***** *** ******* *** * * *** *** ******* * ************* * ******* *********** * * * *
*     *     * *                 *   * *     * *   * * * *       * *             *   *   *       * * *
***** ***** ********* ******* ***** * ***** * *** * * * *** ***** * ***** *** ********* ******* * ***
*               *     * *     *           *   *   * * *   * *           * * * *   * * * * * *       *
***** *** *** *** * * * *** * ***** * * ***** *** * * * *** * ************* ***** * * * * * * *** ***
*     *   *     * * * *     * *     * * *   * *   * * *         *   *   *   * * * * * *         * * *
*** ***** *************** * * *** ***** * *** * *** * * ***** * * *** * * * * * * * * ***** *** *** *
*   * * * *   *           * * *   *         *     *   * * * * * *   * * * * *     *     *     * * * *
***** * ***** ********* *** ***** ********* *** ***** * * * ***** *** ***** *** ***** ***** ***** * *
* * *       * *     *     * * * * * *           * *   *   *         * *   *   *   *                 *
* * *** *** * *** ******* *** * * * * * ***** * * * *** *** ***** *** * *** *** *** * *** * ******* *
* *   * *     * * * * * * *   * * * * * *   * *     *         * * *   * *           * *   *       * *
* * * ******* * * * * * ***** * * * ******* ***** * * * * * *** * * *** *** ***** ******* ***********
* * *         *               * * *   *   * *     *   * * * *   *     * *   *   * *   * * *   * * * *
* *** ******* * ******* * * * * ***** *** * * * * *** *** *** * ******* * *** ******* * * * * * * * *
*     *   *       *     * * *       *     *   * * * * *       * * * * *   *         *       *       *
* * ***** ************* ***** * * *** *** *** ***** * *** * * *** * * * *** ********* * *** *** * ***
* * *     *         * *   * * * *   * *           *     * * *                     *   *   *   * * * *
*** ***** ********* * ***** ***** *********** ***** * ***** ***** * ***** *** ********* * * * * *** *
*   *   *   *     *       * * *     *             * *     *     * *     *   *     *   * * * * *     *
* ***** * ******* ***** *** * *** ***** *** * ********* *** * *** * *** * * * ***** ***** *** *** ***
* * * *   * *   * * *   *     * *   * * *   *         * *   *   * * *   * * * * *     * *   *   *   *
*** * *** * *** * * *** ***** * * *** *** *** ***** *** *** ***** *** ********* * ***** ******* * * *
* * *       *     *   * *                 *   *       *   * *     *       *   * * *           * * * *
* * ******* * *** * *** ******* *** * * * * * * * *** *** *** *** * *** * * *** * * *** * ***********
*     *         *   *   *         * * * * * * * *   *   *   * *   * *   * * *       * * * *     *   *
***** *** *** * *** *** *** * * ******* * *** ***** * * *** * ***** * *** * * * * * * ******* *** * *
*           * * *     *   * * * *       * *       * * *   * * *     *   *     * * *   * * * *   * * *
* ***** * ********* ***** *** ***** * *** * *** ***** ***** * * *** * * * * *********** * * *** * ***
* *     *   *   * *           *     * * * * *       *   *   * * *   * * * * *     *               * *
*** * *** ***** * * ***** ******* * *** ***** *** * ******* * *** * ***** * * *** * *********** * * *
*   *   * *         *       * *   *       *     * *     *   * *   *   *   *   * *             * *   *
*************** ********* *** * *** *** *** *** * * ******* ***** *** *** * * * ***** *** *** ***** *
* *         *   * * * * * * *     * *     *   * * *   *       *   *   *   * *       *   *   *   * * *
* ********* *** * * * * * * *** ***** *** ********* ***** * * ********* ***** * * * *********** * ***
*               *             * * *   *           *   *   * *     *       *   * * *   *       *     *
* *** ***************** ***** *** *** * * * * *** ******* * * * * ********* *** *** *** *************
* *   *                     * *   *   * * * * * * * * *   * * * * *           *   *                 *
***** * *********** *** ***** *** * * * ***** * *** * * *** * ******* * * *** * *** * * * * * * * ***
*     * * *           *     * *     * *   *       *       * *     *   * *   * *   * * * * * * * *   *
* ******* ***** *** *** * * * ***** * *** * *** *** * ***** *** ***** * * *** ***** * *** ***** *** *
* * *             *   * * * * *     *   * * *     * *   *     *     * * *   *   * * * *       * * * *
* * *** * *** * *** *** ********* ***** ***** * * *** * ******* * *** *** *** *** * ***** * ***** ***
*   *   * * * *   * *       * *       *     * * *   * *     *   * *   *     * *       *   *         *
* * ******* * ***** *** * *** *** * *** * ***** * *** * ***** *** ***** * * * ***** *** * * *** *****
* * *   *     *       * *   *     * *   *   * * * *   *   * *   *   *   * * * *   * *   * * *       *
*** *** * * ***** * ***** ***** ******* * *** * *** *** * * ********* *** * *** * ******* * ***** * *
*   *     * *     * *     *   *     *   *   *   *     * *       *     *   *     * * * *   *     * * *
* ******* ***** * * *** * * *** * ***** * * ***** * *** * * ************* * *** * * * * * *** * * * *
* * *     *     * * * * *     * *     * * * *     * * * * *   *   * * * * *   * * *     *   * * * * *
*** ***** *** * *** * *** ***** ***** *** * * ***** * * * * ***** * * * * *** * *** ***** * * *** * *
*         *   *   * *       *     *   *   * * *     *   * *     *         *   *   * *     * *   * * *
* ******* *** * * *** * * * * * ******* * ********* * * ***** *** ***** ***** * ***** * * *** *******
* *   *   *   * * *   * * * * *   *     * *         * *   *     *     *     * * * *   * *   *       *
* * * *** * ***** *** *** * * * ***** * * *** *** * *** ***** ******* *** * ***** *** * * * * * *****
* * *     * * *   *     * * * *     * * * *   *   * *       *     *     * *     * *   * * * * *     *
* * * * * * * * ***** * * * *** * ******* *** * * ***** ***** *** * ***** * *** * * ******* ******* *
* * * * * * *   *   * * * *   * *     *     * * *     * *       * *     * *   *   *   *     *   *   *
* ********* *** * ******* ***** *** *** * *** * * * * ***** ******* ***** * * * * ******* *** * * * *
* *         *         *   *       * *   * *   * * * * *           *   *   * * * *   *         * * * G
*****************************************************************************************************